MARC21 to UNIMARC country-code conversion
-cn	CA
aa	AL
ae	DZ
af	AF
ag	AR
an	AD
ao	AO
aq	AG
as	AS
at	AU
au	AT
ay	NQ
ay	AQ
ba	BH
bb	BB
bd	BI
be	BE
bf	BS
bg	BD
bh	BZ
bi	IO
bl	BR
bm	BM
bo	BO
bp	SB
br	BU
bs	BW
bt	BT
bu	BG
bv	BV
bw	BY
bx	BN
cb	KH
cc	BN
cd	TD
ce	LK
cf	CG
cg	ZR
ch	TW
cj	KY
ck	CO
cl	CL
cm	CM
cp	CT
cq	KM
cr	CR
cu	CU
cv	CV
cw	CK
cx	CF
cy	CY
dk	DK
dm	BJ
dq	DM
dr	DO
ec	EC
eg	GQ
enk	GB
er	EE
es	SV
et	ET
fa	FO
fg	GF
fi	FI
fj	FJ
fk	FK
fp	PF
fr	FR
fs	FQ
ft	DJ
gb	KI
gd	GD
gh	GH
gi	GI
gl	GL
gm	GM
go	GA
gp	GP
gr	GR
gt	GT
gu	GU
gv	GN
gw	DE
gy	GY
hk	HK
hm	HM
ho	HN
ht	HT
hu	HU
ic	IS
ie	IE
ii	IN
io	TP
io	ID
iq	IQ
ir	IR
is	IL
it	IT
iv	CI
iy	NT
ja	JP
ji	JT
jm	JM
jo	JO
ke	KE
kn	KP
ko	KR
ku	KW
lb	LR
le	LB
lh	LI
lo	LS
ls	LA
lu	LU
ly	LY
mc	MC
mf	MU
mg	MG
mh	MO
mj	MS
mk	OM
ml	ML
mm	MT
mp	MN
mq	MQ
mr	MA
mu	MR
mw	MW
mx	MX
my	MY
mz	MZ
na	AN
ne	NL
ng	NE
nl	NC
nn	VU
no	NO
np	NP
nr	NG
nu	NR
nx	NF
nz	NZ
pc	PN
pe	PE
pf	PI
pg	GW
ph	PH
pk	PK
pl	PL
pn	PA
po	PT
pp	PG
pr	PR
py	PY
qa	QA
re	RE
rh	RH
rh	ZW
rm	RO
rw	RW
sa	ZA
sb	SJ
se	SC
sf	ST
sg	SN
si	SG
sj	SD
sl	SL
sm	SM
so	SO
sp	ES
sq	SZ
sr	SR
ss	EH
su	SA
sw	SE
sx	NA
sy	SY
sz	CH
tc	TC
tg	TG
th	TH
ti	TN
tl	TK
to	TO
tr	TT
ts	AE
tt	PC
tu	TR
tv	TV
tz	TZ
ua	EG
uc	NV
ug	UG
un	UA
up	PU
us	US
uv	HV
uy	UY
vb	VG
vc	VA
ve	VE
vi	VI
vm	VN
vp	XV
wf	WF
wk	WK
ws	WS
xa	CX
xb	CC
xc	MV
xd	KN
xf	MI
xh	NU
xj	SH
xk	LC
xl	PM
xm	VC
xo	SK
xp	SI
xr	CZ
xv	SI
xx	SU
xxc	CA
xxk	GB
xxu	US
ye	YE
ys	YD
yu	YU
za	ZM
/
